####################
#..A..B..@C..D..E..#
#......8.........8.#
#.....5.54..8#8.#3.#
#1.#.6...3..6...#..#
#6....#####......8.#
#..####..#....7#..3#
#.2.............58.#
#......8..#..#.....#
#...5.#....68#.3...#
#...3.#86....#.5...#
#.....#..#..8......#
#.85.............2.#
#3..#7....#..####..#
#.8......#####....6#
#..#...6..3...6.#.1#
#.3#.8#8..45.5.....#
#.8.........8......#
#..F..G..HX..I..J..#
####################
